                                                
                                                
                    XXXXXXXX                    
             X     XXXXXXXXX     XXX            
          XXXXX   XXXXXXXXXX     XXXXXX         
        XXXXXXXXXXXXXXXXXXXX      XXXXXXX       
       XXXXXXXXXXXXXXXXXXXX       XXXXXXXX      
     XXXXXXXXXXXXXXXXXXXXXX       XXXXXXXXXX    
    XXXXXXXXXXXXXXXXXXXXXXX       XXXXXXXXXXX   
   XXXXXXXXXXXXXXXXXXXXXXXX       XXXXXXXXXXXX  
   XXXXXXXXXXXXXXXXXXXXXXXX       XXXXXXXXXXXX  
  XXXXXXXXXXXXXXXXXXXXXXXX        XXXXXXXXXXXXX 
 XXXXXXXXXXXXXXXXXXXXXXXXX       XXXXXXXXXXXXXXX
 XXXXXXXXXXXXXXXXXXXXXXXX        XXXXXXXXXXXXXXX
 XXXXXXXXXXXXXXXXXXXXXXXX       XXXXXXXXXXXXXXXX
 XXXXXXXXXXXXXXXXXXXXXXX       XXXXXXXXXXXXXXXX 
 XXXXXXXXXXXXXXXXXXXXXXX       XXXXXXXXXXXXXXX  
 XXXXXXXXXXXXXXXXXXXXXX        XXXXXXXXXXXXX    
 XXXXXXXXXX     XXXXXX        XXXXXXXXXXXXX     
 XXXXXXXXX       XXXX         XXXXXXXXXXXX      
 XXXXXXXX         X           XXXXXXXXXXX       
  XXXXXX                     XXXXXXXXXXXX       
   XXXX                      XXXXXXXXXXXX       
   XXXX                      XXXXXXXXXXXX       
    XX          X            XXXXXXXXXXXX       
              XXXX           XXXXXXXXXXXXXXX    
             XXXXXX          XXXXXXXXXXXXX      
            XXXXXXX          XXXXXXXXXXXX       
           XXXXXXXXX         XXXXXXXXXX         
             XXXXXXXX       XXXXXXXX            
                 XXXXX      XXXX                
                                                
